12:137/300
############
#.        .#
#    #  ####
#    #  ####
# $  #  ####
#    @# $  #
#  #  #$   #
#  #$ # ####
#  #  #    #
#  #  #    #
#. #      .#
############