12:68:7:0
############
#    @    .#
#   $#     #
#### #     #
#  # #.    #
#    ####$ #
# $####    #
#    .# #  #
#     # ####
#     #$   #
#.    @    #
############
