12:133/300
  #######   
###     ####
#  $###    #
#      $   #
#          #
####    ## #
####    $  #
#     #### #
#       $  #
#     ######
#@     ....#
############