5:5
#####
#  .#
# $ #
#@  #
#####
