12:122:5:2666/300
    ########
#####      #
#          #
#    $     #
###%# %    #
# #  $  $$ #
# # #      #
# # # $  ###
#  $  #  ..#
# @   #  ..#
#        ..#
############
