12:122:1:0/300
    ########
#####      #
#          #
#    $     #
###%# %    #
#@#  $  $$ #
# # #      #
# # # $  ###
#  $  #  ..#
#     #  ..#
#        ..#
############
