12:1000/300
    ########
#####      #
#          #
#     ######
#.##@$     #
#####  $  .#
#.#### $   #
# #    .   #
# #  $$$ ###
#$  .     .#
#      .   #
############